2,2,2,2,2,2,2,2
2,9,12,12,12,12,10,2
2,13,4,15,1,4,11,2
2,13,4,1,1,16,11,2
2,13,1,5,1,1,11,2
2,13,1,1,3,1,11,2
2,8,14,14,14,14,7,2
2,2,2,2,2,2,2,2
