1,1,1,1,1,1,1,1,1,1,1,1,1
1,1,1,1,1,1,1,1,1,1,1,1,1
1,1,1,1,1,1,1,1,1,1,1,1,1
1,1,1,1,1,1,1,1,1,1,1,1,1
1,1,1,1,6,2,2,2,7,1,1,1,1,
1,1,1,1,5,14,11,14,4,1,1,1,1,
1,1,1,1,15,0,0,0,16,1,1,1,1,
1,1,1,1,15,14,0,14,16,1,1,1,1,
1,1,1,1,15,18,0,0,16,1,1,1,1,
1,1,1,1,15,14,0,14,16,1,1,1,1,
1,1,1,1,5,0,10,12,4,1,1,1,1,
1,1,1,1,8,3,3,3,9,1,1,1,1
1,1,1,1,1,1,1,1,1,1,1,1,1
1,1,1,1,1,1,1,1,1,1,1,1,1
1,1,1,1,1,1,1,1,1,1,1,1,1
1,1,1,1,1,1,1,1,1,1,1,1,1
