1,1,1,1,1,1,1,1,1,1,1
1,6,2,2,2,2,2,2,2,7,1
1,5,0,0,0,11,0,0,0,4,1
1,5,0,0,0,0,0,0,0,4,1
1,5,0,0,0,0,0,0,0,4,1
1,5,0,0,0,10,0,0,0,4,1
1,8,3,3,3,3,3,3,3,9,1
1,1,1,1,1,1,1,1,1,1,1
