1,1,1,1,1
6,2,2,2,7
5,0,11,0,4
5,0,0,0,4
5,0,0,0,4
5,0,10,0,4
8,3,3,3,9
