33,32,32,32,32,32,32,32,32,32,32,32,32,34,
31,1,1,1,1,1,1,1,1,1,1,1,1,31,
31,1,15,1,1,15,1,5,1,1,1,15,1,31,
31,1,1,1,1,1,1,1,1,1,1,1,1,31,
31,15,1,1,1,1,1,1,1,15,1,1,1,31,
31,1,22,23,1,5,1,1,1,1,1,15,1,31,
31,1,25,24,1,1,1,1,1,1,1,1,1,31,
31,1,18,19,1,1,1,15,1,5,22,23,1,31,
31,1,1,1,1,1,1,1,1,1,25,24,1,31,
31,1,1,1,5,1,1,1,1,1,18,19,1,31,
31,1,15,1,1,1,1,15,1,1,1,1,1,31,
31,29,1,1,1,1,1,3,1,1,1,1,1,31,
35,32,32,32,32,32,32,32,32,32,32,32,32,36,
18,17,17,17,17,17,17,17,17,17,17,17,17,19
