6,6,6,6,6,6,6,6,6,6
6,7,8,8,8,8,8,8,9,6
6,14,0,0,0,0,0,0,10,6
6,14,0,5,2,5,0,0,10,6
6,14,0,0,0,0,0,0,10,6
6,13,12,12,12,12,12,12,11,6
6,6,6,6,6,6,6,6,6,6
