7,8,8,8,8,8,8,8,8,9,
14,18,0,17,16,15,16,0,0,10,
14,0,5,0,0,21,0,5,0,10,
14,0,0,0,0,0,0,0,0,10,
14,0,20,0,0,0,19,0,0,10,
14,0,5,0,0,0,0,5,0,10,
14,0,0,0,0,0,0,0,0,10,
14,0,0,0,20,0,0,0,3,10,
14,0,5,0,0,0,0,5,0,10,
13,12,12,12,12,12,12,12,12,11
