7,8,8,8,8,8,8,8,8,8,8,9,
14,0,16,16,0,0,0,21,5,0,0,10,
14,0,15,17,0,25,0,0,0,0,0,10,
14,0,16,16,10,6,14,0,0,0,0,10,
14,0,0,5,10,6,14,18,0,5,0,10,
14,19,0,0,10,6,14,0,0,0,0,10,
14,0,0,0,22,24,23,0,0,0,20,10,
14,5,0,19,10,6,14,0,0,0,0,10,
14,0,0,0,10,6,14,0,5,0,0,10,
14,0,0,5,0,26,0,0,0,0,0,10,
14,0,20,0,0,0,0,19,0,0,0,10,
13,12,12,12,12,12,12,12,12,12,12,11
