43,43,42,43,42,43,42,42,42,42,42,42,42,43,43,42,43,42,43,
42,42,43,42,42,42,42,42,42,42,42,42,42,42,42,42,42,42,43,
42,42,42,42,42,42,42,42,42,42,42,42,42,42,42,42,42,42,42,
42,42,42,42,43,43,42,42,42,43,42,43,42,42,43,42,42,42,42,
42,42,42,42,43,42,42,43,42,42,42,42,43,42,42,42,43,42,43
42,42,43,42,42,9,9,10,12,12,12,12,12,10,42,42,42,42,42
43,42,42,42,42,13,25,24,1,1,1,1,1,11,42,43,42,42,43
42,42,42,42,42,13,18,19,1,21,16,1,1,11,42,42,42,43,42
42,42,43,42,42,13,1,4,5,1,5,4,15,11,42,42,42,42,42,
43,42,42,43,42,13,1,15,1,1,1,1,1,11,42,42,42,42,43,
42,42,42,42,43,13,1,1,5,1,5,22,23,11,43,42,42,42,42,
43,42,42,42,42,13,1,1,1,1,15,25,24,11,42,43,42,42,43
42,42,42,42,43,13,1,1,5,3,5,18,19,11,42,42,43,42,42,
42,42,42,42,42,8,14,14,14,14,14,14,14,7,42,42,42,42,42,
43,42,43,43,42,42,42,42,42,42,43,42,42,42,42,43,42,43,42
42,43,42,43,42,42,42,43,42,42,42,42,42,42,42,42,43,42,43,
42,42,43,42,42,42,42,42,42,42,42,42,42,42,42,42,42,42,43,
42,42,43,42,43,43,42,42,42,43,42,43,42,43,42,42,43,43,43,
43,42,43,42,43,43,42,43,42,43,42,43,42,43,43,42,43,42,42,
