2,2,2,2,2,2,2,2,2,2,2
2,9,9,10,12,12,12,12,12,10,2
2,13,25,24,1,1,1,1,1,11,2
2,13,18,19,1,21,16,1,1,11,2
2,13,1,4,5,1,5,4,15,11,2
2,13,1,15,1,1,1,1,1,11,2
2,13,1,1,5,1,5,22,23,11,2
2,13,1,1,1,1,15,25,24,11,2
2,13,1,1,5,3,5,18,19,11,2
2,8,14,14,14,14,14,14,14,7,2
2,2,2,2,2,2,2,2,2,2,2
